#######################################
# P ###################################
## ################################## #
## #                                  #
## # ################################ #
## # ################################ #
## #                                # #
## ################################ # #
## ################################ # #
## #                                # #
## # ################################ #
## #                                # #
## ### ############# ########## ##### #
## ### ############# ##########   ### #
## ### ##########################  ## #
## ### ########################### ## #
## ### ########################### ## #
## ### ########################### ## #
## ### ########################### ## #
## #   ###########################O## #
## #X ############################### #
##                                    #
#######################################
